a	a
ai	ai
an	an
ang	ang
ao	ao
b	b
c	c
ch	ch
d	d
e	e
ei	ei
en	en
eng	eng
er	er
f	f
g	g
h	h
i	i
ia	ia
ian	ian
iang	iang
iao	iao
ie	ie
in	in
ing	ing
iong	iong
iu	iu
j	j
k	k
l	l
m	m
n	n
o	o
ong	ong
ou	ou
p	p
q	q
r	r
s	s
sh	sh
t	t
u	u
ua	ua
uai	uai
uan	uan
uang	uang
ui	ui
un	un
uo	uo
v	v
van	van
ve	ve
vn	vn
w	w
x	x
y	y
z	z
zh	zh
