N	N
a	a
b	b
ch	ch
cl	cl
d	d
e	e
f	f
g	g
h	h
i	i
j	j
k	k
ky	ky
m	m
n	n
ny	ny
o	o
p	p
py	py
q	q
r	r
ry	ry
s	s
sh	sh
t	t
ts	ts
ty	ty
u	u
vf	vf
w	w
y	y
z	z
