EP	EP
Eo	Eo
Ep	Ep
GS	GS
M	M
N	N
PE	PE
SO	SO
Sp	Sp
a	a
aa	aa
ae	ae
ah	ah
ao	ao
aw	aw
ax	ax
ay	ay
b	b
ch	ch
cl	cl
ctrash	ctrash
d	d
dh	dh
dr	dr
dx	dx
eh	eh
en	en
er	er
exh	exh
ey	ey
f	f
g	g
hh	hh
i	i
ih	ih
iy	iy
jh	jh
k	k
l	l
m	m
n	n
ng	ng
oh	oh
ow	ow
oy	oy
p	p
q	q
r	r
s	s
sh	sh
t	t
th	th
tr	tr
uh	uh
uw	uw
v	v
vf	vf
w	w
x	x
y	y
z	z
zh	zh
