K	K
L	L
M	M
N	N
NG	NG
P	P
T	T
a	a
b	b
cL	cL
ch	ch
d	d
e	e
eb	eb
eo	eo
eu	eu
g	g
h	h
i	i
j	j
jj	jj
k	k
kk	kk
m	m
n	n
o	o
p	p
pp	pp
r	r
s	s
ss	ss
t	t
tt	tt
u	u
vf	vf
w	w
y	y
